0  0  0  0  5  0  0  4  0  0  0  0
0  0  6  6  4  0  0  5  0  0  0  0
0  0  1  0  5  3  0  4  0  0  0  0
0  0  0  0  4 -2 -2  5  0  0  0  0
0  0  0  0  5  3  0  4  1  0  0  0
0  0  0  0  4  0  0  5  6  6  0  0
0  0  0  0  5  0  0  4  0  0  0  0
4 350 450 0.5 3
-1 550 410 0 0
-1 400 170 0 0
-1 700 390 0 0
-1 550 150 0 0