0  0  0  0  0  0  0  0  0  0  7  0
7  0  0  7  0  0  3  0 -1  0  0  0 
7  0  0  7 -2  6 -4  0  6  0  7  0
7  0  0  7  0  6  5  4  6  0  7  0
7  3  0  7  0  6  0  0  6  0  7  0
7  0  0  7  0  6  0  0  6  0  7 -1
7  0  0  7  0  6  0  0  6  0  7  0
1 250 100 0.5 0
1 910 450 0.5 2