1  0  1  0  1  0  1  0  1  0  1  0
0  0  1  0  1  0  1  0  1  0  0  0 
0  0  1  0  2  0  2  0  1  0  0  0
0  5  2  0 -1  6  6 -1  2  0  4  0
0  0  1  0  2  0  2  0  1  0  0  0
0  0  1  0  1  0  1  0  1  0  0  0
1  0  1  0  1  0  1  0  1  0  1  0
1 260 100 0.5 0