7  0  7  0  7  0  7  0  7  0  7  0
0  7  0  7 -1  7 -4  7 -1  7  0  7
7  0  7  0  7  0  7  0  7  0  7  0
0  7 -1  7  0  7 -3  7  0  7 -1  7
7  0  7  0  7  0  7  0  7  0  7  0
0  7  0  7 -1  7  0  7 -1  7  0  7
7  0  7  0  7  0  7  0  7  0  7  0
5 500 270 0 0 
2 905 100 0.5 1