4  5  4  5  4  5  4  5  4  5  4  5  
4  0  0  0  -1 0  0 -1  0  0  0  5  
4  7  7  7  7  7  7  7  7  7  7  5  
4  0 -1  0  7 -4 -3  7  0 -1  0  5  
4  7  7  7  7  7  7  7  7  7  7  5  
4  0  0  0 -1  0  0 -1  0  0  0  5  
4  5  4  5  4  5  4  5  4  5  4  5
1 220 120  1 0 
3 260  90  1 1